基本信息	#
就诊信息	#
治疗方案	#
住院记录	#
入院记录	#
出院记录	#
成药:	medcine
出院情况及治疗结果:	effect
出院医嘱:	advice
出院诊断:	diagnosis
当前状态:	status
放疗:	radiotherapy
辅助检查:	acce_exam
个人史:	person_his
化疗:	chemotherapy
患病年龄:	age
家族史:	family_his
其它:	other
确诊时间:	diagnosis_date
入院情况及诊疗经过:	med_exp
手术:	surgery
体格检查:	body_exam
现病史:	med_his
姓名:	name
性别:	gender
医生评价:	doctor_comment
医学检查:	med_exam
医院评价:	hospital_comment
治疗时间:	treat_date
治疗医院:	treat_hospital
中草药:	herbal
主诉:	complain
主要症状:	symptom
住院天数:	days
专科检查:	spec_exam
